A: The first letter of the English and of many other alphabets.

AARD-VARK: An edentate mammal, of the genus Orycteropus, somewhat resembling a pig, common in some parts of Southern Africa. It burrows in the ground, and feeds entirely on ants, which it catches with its long, slimy tongue.

AARD-WOLF: A carnivorous quadruped (Proteles Lalandii), of South Africa, resembling the fox and hyena. See Proteles.

AARONIC: Pertaining to Aaron, the first high priest of the Jews.

ABACINATE: To blind by a red-hot metal plate held before the eyes. [R.]

ABACINATION: The act of abacinating. [R.]

ABACISCUS: One of the tiles or squares of a tessellated pavement; an abaculus.

ABACIST: One who uses an abacus in casting accounts; a calculator.

ABACK: Backward against the mast;-said of the sails when pressed by the wind. Totten. To be taken aback. (a) To be driven backward against the mast; -- said of the sails, also of the ship when the sails are thus driven. (b) To be suddenly checked, baffled, or discomfited. Dickens.

ABACTINAL: Pertaining to the surface or end opposite to the mouth in a radiate animal; -- opposed to actinal. "The aboral or abactinal area." L. Agassiz.

ABACTION: Stealing cattle on a large scale. [Obs.]

ABACTOR: One who steals and drives away cattle or beasts by herds or droves. [Obs.]

ABACULUS: A small tile of glass, marble, or other substance, of various colors, used in making ornamental patterns in mosaic pavements. Fairholt.

ABACUS: A table or tray strewn with sand, anciently used for drawing, calculating, etc. [Obs.]

ABADA: The rhinoceros. [Obs.] Purchas.

ABADDON: The destroyer, or angel of the bottomless pit; -- the same as Apollyon and Asmodeus.

ABAFT: Toward the stern; aft; as, to go abaft.

ABAISANCE: Obeisance. [Obs.] Jonson.

ABAISER: Ivory black or animal charcoal. Weale.

ABAIST: Abashed; confounded; discomfited. [Obs.] Chaucer.

ABALIENATE: To transfer the title of from one to another; to alienate.

ABALIENATION: The act of abalienating; alienation; estrangement. [Obs.]

ABALONE: A univalve mollusk of the genus Haliotis. The shell is lined with mother-of-pearl, and used for ornamental purposes; the sea-ear. Several large species are found on the coast of California, clinging closely to the rocks.

ABAND: To abandon. [Obs.]

ABANDON: To cast or drive out; to banish; to expel; to reject. [Obs.]

ABANDONEDLY: Unrestrainedly.

ABANDONEE: One to whom anything is legally abandoned.

ABANDONER: One who abandons. Beau. & Fl.

ABANDONMENT: The act of abandoning, or the state of being abandoned; total desertion; relinquishment.

ABANDUM: Anything forfeited or confiscated.

ABANET: See Abnet.

ABANGA: A West Indian palm; also the fruit of this palm, the seeds of which are used as a remedy for diseases of the chest.

ABANNATION: Banishment. [Obs.] Bailey.

ABARTICULATION: Articulation, usually that kind of articulation which admits of free motion in the joint; diarthrosis. Coxe.

ABASE: To lower or depress; to throw or cast down; as, to abase the eye.

ABASEMENT: The act of abasing, humbling, or bringing low; the state of being abased or humbled; humiliation.

ABASER: He who, or that which, abases.

ABASH: To destroy the self-possession of; to confuse or confound, as by exciting suddenly a consciousness of guilt, mistake, or inferiority; to put to shame; to disconcert; to discomfit.

BREAKDOWN: The act or result of breaking down, as of a carriage; downfall.

BREAKER: One who, or that which, breaks.

BREAKFAST: The first meal in the day, or that which is eaten at the first meal.

BREAKNECK: A fall that breaks the neck.

BREAKWATER: Any structure or contrivance, as a mole, or a wall at the mouth of a harbor, to break the force of waves, and afford protection from their violence.

BREAM:A European fresh-water cyprinoid fish of the genus Abramis, ittle valued as food. Several species are known.

BREAST: The fore part of the body, between the neck and the belly; the hest; as, the breast of a man or of a horse.

BREASTBONE: The bone of the breast; the sternum.

BREASTFAST: A large rope to fasten the midship part of a ship to a wharf, or to another vessel.

BREASTHOOK: A thick piece of timber in the form of a knee, placed across the stem of a ship to strengthen the fore part and unite the bows on each side. Totten.

BREASTPLATE: A plate of metal covering the breast as defensive armor. Before his old rusty breastplate could be scoured, and his cracked headpiece mended. Swift.

BREATH: The air inhaled and exhaled in respiration, air which, in the process of respiration, has parted with oxygen and has received carbonic acid, aqueous vapor, warmth, etc. Melted as breath into the wind. Shak.

BREATHE: To respire; to inhale and exhale air; hence;, to live. "I am in health, I breathe." Shak. Breathes there a man with soul so dead Sir W. Scott.

BREATHING: Respiration; the act of inhaling and exhaling air. Subject to a difficulty of breathing. Melmoth.

BREED: To bear and nourish young; to reproduce or multiply itself; to be pregnant. That they breed abundantly in the earth. Gen. viii. 17. The mother had never bred before. Carpenter. Ant. Is your gold and silver ewes and rams Shy. I can not tell. I make it breed as fast. Shak.

BREEZE: A light, gentle wind; a fresh, soft-blowing wind. Into a gradual calm the breezes sink. Wordsworth.

BRETZEL: See Pretzel.

BREW: The mixture formed by brewing; that which is brewed. Bacon.

BREWING: The act or process of preparing liquors which are brewed, as beer and ale.

BRIBE: To rob or steal. [Obs.] Chaucer.

BRIBERY: Robbery; extortion. [Obs.]

BRICK: A block or clay tempered with water, sand, etc., molded into a regular form, usually rectangular, and sun-dried, or burnt in a kiln, or in a heap or stack called a clamp. The Assyrians appear to have made much less use of bricks baked in the furnace than the Babylonians. Layard.

BRIDE: A woman newly married, or about to be married. Has by his own experience tried How much the wife is dearer than the bride. Lyttleton. I will show thee the bride, the Lamb's wife. Rev. xxi. 9.

BRIDEGROOM: A man newly married, or just about to be married.

BRIDGE: A structure, usually of wood, stone, brick, or iron, erected over a river or other water course, or over a chasm, railroad, etc., to make a passageway from one bank to the other.

BRIEF: Short in duration. How brief the life of man. Shak.

BRIGADE: A body of troops, whether cavalry, artillery, infantry, or mixed, consisting of two or more regiments, under the command of a brigadier general.

BRIM: The rim, border, or upper sdge of a cup, dish, or any hollow vessel used for holding anything. Saw I that insect on this goblet's brim I would remove it with an anxious pity. Coleridge.

BROADCAST: Cast or dispersed in all directions, as seed from the hand in sowing; widely diffused.

BROIL: To be subjected to the action of heat, as meat over the fire; to be greatly heated, or to be made uncomfortable with heat. The planets and comets had been broiling in the sun. Cheyne.

BROMINE: One of the elements, related in its chemical qualities to chlorine and iodine. Atomic weight 79.8. Symbol Br. It is a deep reddish brown liquid of a very disagreeable odor, emitting a brownish vapor at the ordinary temperature. In combination it is found in minute quantities in sea water, and in many saline springs. It occurs also in the mineral bromyrite.

BRONZE: An alloy of copper and tin, to which small proportions of other metals, especially zinc, are sometimes added. It is hard and sonorous, and is used for statues, bells, cannon, etc., the proportions of the ingredients being varied to suit the particular purposes. The varieties containing the higher proportions of tin are brittle, as in bell metal and speculum metal.

BROOCH: An ornament, in various forms, with a tongue, pin, or loop for attaching it to a garment; now worn at the breast by women; a breastpin. Formerly worn by men on the hat. Honor 's a good brooch to wear in a man's hat. B. Jonson.

BROOM: An implement for sweeping floors, etc., commonly made of the panicles or tops of broom corn, bound together or attached to a long wooden handle; -- so called because originally made of the twigs of the broom. Butcher's broom, a plant (Ruscus aculeatus) of the Smilax family, used by butchers for brooms to sweep their blocks; -- called also knee holly. See Cladophyll. -- Dyer's broom, a species of mignonette (Reseda luteola), used for dyeing yellow; dyer's weed; dyer's rocket. -- Spanish broom. See under Spanish.

BROTHER: A male person who has the same father and mother with another person, or who has one of them only. In the latter case he is more definitely called a half brother, or brother of the half blood. Two of us in the churchyard lie, My sister and my brother. Wordsworth.

BROW: The prominent ridge over the eye, with the hair that covers it, forming an arch above the orbit. And his arched brow, pulled o'er his eyes, With solemn proof proclaims him wise. Churchill.

BROWN: Of a dark color, of various shades between black and red or yellow. Cheeks brown as the oak leaves. Longfellow. Brown Bess, the old regulation flintlock smoothbore musket, with bronzed barrel, formerly used in the British army.

BRUSH: To apply a brush to, according to its particular use; to rub, smooth, clean, paint, etc., with a brush. "A' brushes his hat o' mornings." Shak.

BUCCANEER: A robber upon the sea; a pirate; -- a term applied especially to the piratical adventurers who made depredations on the Spaniards in America in the 17th and 18th centuries. [Written also bucanier.]

BUCK: The male of deer, especially fallow deer and antelopes, or of goats, sheep, hares, and rabbits.

BUFFET: A cupboard or set of shelves, either movable or fixed at one side of a room, for the display of plate, china, etc., a sideboard. Not when a gilt buffet's reflected pride Turns you from sound philosophy aside. Pope.

BUILD: To erect or construct, as an edifice or fabric of any kind; to form by uniting materials into a regular structure; to fabricate; to make; to raise. Nor aught availed him now To have built in heaven high towers. Milton.

BULL: The male of any species of cattle (Bovidæ); hence, the male of any large quadruped, as the elephant; also, the male of the whale.

BUMBLEBEE: A large bee of the genus Bombus, sometimes called humblebee; -- so named from its sound.

BUNDLE: A number of things bound together, as by a cord or envelope, into a mass or package convenient for handling or conveyance; a loose package; a roll; as, a bundle of straw or of paper; a bundle of old clothes. The fable of the rods, which, when united in a bundle, no strength could bend. Goldsmith. Bundle pillar (Arch.), a column or pier, with others of small dimensions attached to it. Weale.

COMPREHEND: To take into the mind; to grasp with the understanding; to apprehend the meaning of; to understand. At a loss to comprehend the question. W. Irwing. Great things doeth he, which we can not comprehend. Job. xxxvii. 5.

COMPRESS: To press or squeeze together; to force into a narrower compass; to reduce the volume of by pressure; to compact; to condense; as, to compress air or water. Events of centuries . . . compressed within the compass of a single life. D. Webster. The same strength of expression, though more compressed, runs through his historical harangues. Melmoth.

COMPROMISE: A mutual agreement to refer matters in dispute to the decision of arbitrators. [Obs.] Burrill.

COMPUTE: To determine calculation; to reckon; to count. Two days, as we compute the days of heaven. Milton. What's done we partly may compute, But know not what's resisted. Burns.

CONCATENATE: To link together; to unite in a series or chain, as things depending on one another. This all things friendly will concatenate. Dr. H. More

CONCEDE: To yield or suffer; to surrender; to grant; as. to concede the point in question. Boyle.

CONCENTRATION: The act or process of concentrating; the process of becoming concentrated, or the state of being concentrated; concentration. Concentration of the lunar beams. Boyle. Intense concetration of thought. Sir J. Herschel.

CONCISE: Expressing much in a few words; condensed; brief and compacted; -- used of style in writing or speaking. The concise style, which expresseth not enough, but leaves somewhat to be understood. B. Jonson. Where the author is . . . too brief and concise, amplify a little. I. Watts.

CONDOR: A very large bird of the Vulture family (Sarcorhamphus gryphus), found in the most elevated parts of the Andes.

CONFIDENTIAL: Enjoying, or treated with, confidence; trusted in; trustworthy; as, a confidential servant or clerk.

CONJUNCTION: The act of conjoining, or the state of being conjoined, united, or associated; union; association; league. He will unite the white rose and the red: Smille heaven upon his fair conjunction. Shak. Man can effect no great matter by his personal strength but as he acts in society and conjunction with others. South.

CONSTANT: Remaining unchanged or invariable, as a quantity, forc, law, etc.

CRYSTAL: The regular form which a substance tends to assume in solidifying, through the inherent power of cohesive attraction. It is bounded by plane surfaces, symmetrically arranged, and each species of crystal has fixed axial ratios. See Crystallization.

DISPATCH: To make haste; to conclude an affair; to finish a matter of business. They have dispatched with Pompey. Shak.

DISPERSE: To scatter abroad; to drive to different parts; to distribute; to diffuse; to spread; as, the Jews are dispersed among all nations. The lips of the wise disperse knowledge. Prov. xv. 7. Two lions, in the still, dark night, A herd of beeves disperse. Cowper.

DISPLEASE: To make not pleased; to excite a feeling of disapprobation or dislike in; to be disagreeable to; to offend; to ex; -- often followed by with or at. It usually expresses less than to anger, vex, irritate, or provoke. God was displeased with this thing. 1 Chron. xxi. 7. Wilt thou be displeased at us forever Psalms lxxxv. 5 (Bk. of Com. Prayer). This virtuous plaster will displease Your tender sides. J. Fletcher. Adversity is so wholesome . . . why should we be displeased therewith Barrow.

DISPOSITION: The act of disposing, arranging, ordering, regulating, or transferring; application; disposal; as, the disposition of a man's property by will. Who have received the law by the disposition of angels. Acts vii. 53. The disposition of the work, to put all things in a beautiful order and harmony, that the whole may be of a piece. Dryden.

DISTINCT: Distinguished; having the difference marked; separated by a visible sign; marked out; specified. [Obs.] Wherever thus created -- for no place Is yet distinct by name. Milton.

DIVISOR: The number by which the dividend is divided. Common divisor. (Math.) See under Common, a.

DOLPHIN: A cetacean of the genus Delphinus and allied genera (esp. D. delphis); the true dolphin. (b) The Coryphæna hippuris, a fish of about five feet in length, celebrated for its surprising changes of color when dying. It is the fish commonly known as the dolphin. See Coryphænoid.

DOUBT: To question or hold questionable; to withhold assent to; to hesitate to believe, or to be inclined not to believe; to withhold confidence from; to distrust; as, I have heard the story, but I doubt the truth of it. To admire superior sense, and doubt their own! Pope. I doubt not that however changed, you keep So much of what is graceful. Tennyson. To doubt not but. I do not doubt but I have been to blame. Dryden. We doubt not now But every rub is smoothed on our way. Shak.

DUPLICATE: That which exactly resembles or corresponds to something else; another, correspondent to the first; hence, a copy; a transcript; a counterpart. I send a duplicate both of it and my last dispatch. Sir W. Temple.

EXAMINATION: The act of examining, or state of being examined; a careful search, investigation, or inquiry; scrutiny by study or experiment.

FISH: A name loosely applied in popular usage to many animals of diverse characteristics, living in the water.

FISSURE: A narrow opening, made by the parting of any substance; a cleft; as, the fissure of a rock. Cerebral fissures (Anat.), the furrows or clefts by which the surface of the cerebrum is divided; esp., the furrows first formed by the infolding of the whole wall of the cerebrum.

FIVE: The number next greater than four, and less than six; five units or objects. Five of them were wise, and five were foolish. Matt. xxv. 2.

FLAG: A cloth usually bearing a device or devices and used to indicate nationality, party, etc., or to give or ask information; -- commonly attached to a staff to be waved by the wind; a standard; a banner; an ensign; the colors; as, the national flag; a military or a naval flag.

FORTUNE: Wealth; large possessions; large estate; riches; as, a gentleman of fortune.

GUTTER: A channel at the eaves of a roof for conveying away the rain; an eaves channel; an eaves trough.

HOCKEY: A game in which two parties of players, armed with sticks curved or hooked at the end, attempt to drive any small object (as a ball or a bit of wood) toward opposite goals.

HOIST: To raise; to lift; to elevate; esp., to raise or lift to a desired elevation, by means of tackle, as a sail, a flag, a heavy package or weight. They land my goods, and hoist my flying sails. Pope. Hoisting him into his father's throne. South. Hoisting engine, a steam engine for operating a hoist.

INFEST: To trouble greatly by numbers or by frequency of presence; to disturb; to annoy; to frequent and molest or harass; as, fleas infest dogs and cats; a sea infested with pirates. To poison vermin that infest his plants. Cowper. These, said the genius, are envy, avarice, superstition, love, with the like cares and passions that infest human life. Addison. And the cares, that infest the day, Shall fold their tents, like the Arabs, And as silently steal away. Longfellow.

INVASION: The act of invading; the act of encroaching upon the rights or possessions of another; encroachment; trespass.

KUMQUAT: A small tree of the genus Citrus (C. Japonica) growing in China and Japan; also, its small acid, orange-colored fruit used for preserves.

LATCH: That which fastens or holds; a lace; a snare. [Obs.] Rom. of R.

LATIN: Of or pertaining to Latium, or to the Latins, a people of Latium; Roman; as, the Latin language.

LATTICE: Any work of wood or metal, made by crossing laths, or thin strips, and forming a network; as, the lattice of a window; -- called also latticework. The mother of Sisera looked out at a window, and cried through the lattice. Judg. v. 28.

MAJOR: An officer next in rank above a captain and next below a lieutenant colonel; the lowest field officer.

MALADY: Any disease of the human body; a distemper, disorder, or indisposition, proceeding from impaired, defective, or morbid organic functions; especially, a lingering or deep-seated disorder. The maladies of the body may prove medicines to the mind. Buckminster.

MANIAC: A raving lunatic; a madman.

MARKET: A public place (as an open space in a town) or a large building, where a market is held; a market place or market house; esp., a place where provisions are sold. There is at Jerusalem by the sheep market a pool. John v. 2.

MARTIAL: Belonging to war, or to an army and navy; -- opposed to civil; as, martial law; a court-martial.

MEASURE: A standard of dimension; a fixed unit of quantity or extent; an extent or quantity in the fractions or multiples of which anything is estimated and stated; hence, a rule by which anything is adjusted or judged.

MERRY: Laughingly gay; overflowing with good humor and good spirits; jovial; inclined to laughter or play ; sportive. They drank, and were merry with him. Gen. xliii. 34. I am never merry when I hear sweet music. Shak.

MILK: A white fluid secreted by the mammary glands of female mammals for the nourishment of their young, consisting of minute globules of fat suspended in a solution of casein, albumin, milk sugar, and inorganic salts. "White as morne milk." Chaucer.

MISSPELLING: A wrong spelling.

MONOPOLY: The exclusive power, or privilege of selling a commodity; the exclusive power, right, or privilege of dealing in some article, or of trading in some market; sole command of the traffic in anything, however obtained; as, the proprietor of a patented article is given a monopoly of its sale for a limited time; chartered trading companies have sometimes had a monopoly of trade with remote regions; a combination of traders may get a monopoly of a particular product. Raleigh held a monopoly of cards, Essex a monopoly of sweet wines. Macaulay.

MOUSE: Any one of numerous species of small rodents belonging to the genus Mus and various related genera of the family Muridæ. The common house mouse (Mus musculus) is found in nearly all countries. The American white-footed, or deer, mouse (Hesperomys leucopus) sometimes lives in houses. See Dormouse, Meadow mouse, under Meadow, and Harvest mouse, under Harvest.

MUSSEL: Any one of many species of marine bivalve shells of the genus Mytilus, and related genera, of the family Mytidæ. The common mussel (Mytilus edulis; see Illust. under Byssus), and the larger, or horse, mussel (Modiola modiolus), inhabiting the shores both of Europe and America, are edible. The former is extensively used as food in Europe.

NAVEL: A mark or depression in the middle of the abdomen; the umbilicus. See Umbilicus.belly button in humans

NEITHER: not either; generally used to introduce the first of two or more coördinate clauses of which those that follow begin with nor. Fight neither with small nor great, save only with the king. 1 Kings xxii. 31. Hadst thou been firm and fixed in thy dissent, Neither had I transgressed, nor thou with me. Milton. When she put it on, she made me vow That I should neither sell, nor give, nor lose it. Shak.

NITROGLYCERIN: A liquid appearing like a heavy oil, colorless or yellowish, and consisting of a mixture of several glycerin salts of nitric acid, and hence more properly called glycerin nitrate. It is made by the action of nitric acid on glycerin in the presence of sulphuric acid. It is extremely unstable and terribly explosive. A very dilute solution is used in medicine as a neurotic under the name of glonion. [Written also nitroglycerine.]

NOTHING: Not anything; no thing (in the widest sense of the word thing); -- opposed to Ant: anything and Ant: something. Yet had his aspect nothing of severe. Dryden.

OBELISK: An upright, four-sided pillar, gradually tapering as it rises, and terminating in a pyramid called pyramidion. It is ordinarily monolithic. Egyptian obelisks are commonly covered with hieroglyphic writing from top to bottom.

ODYSSEY: An epic poem attributed to Homer, which describes the return of Ulysses to Ithaca after the siege of Troy.

OLIVE: A tree (Olea Europæa) with small oblong or elliptical leaves, axillary clusters of flowers, and oval, one-seeded drupes. The tree has been cultivated for its fruit for thousands of years, and its branches are the emblems of peace. The wood is yellowish brown and beautifully variegated. (b) The fruit of the olive. It has been much improved by cultivation, and is used for making pickles. Olive oil is pressed from its flesh.

OPINION: The judgment or sentiment which the mind forms of persons or things; estimation. I have bought golden opinions from all sorts of people. Shak. Friendship . . . gives a man a peculiar right and claim to the good opinion of his friend. South. However, I have no opinion of those things. Bacon.

OSMIUM: A rare metallic element of the platinum group, found native as an alloy in platinum ore, and in iridosmine. It is a hard, infusible, bluish or grayish white metal, and the heaviest substance known. Its tetroxide is used in histological experiments to stain tissues. Symbol Os. Atomic weight 191.1. Specific gravity 22.477.

OVERBOARD: Over the side of a ship; hence, from on board of a ship, into the water; as, to fall overboard. To throw overboard, to discard; to abandon, as a dependent or friend.

PAGAN: One who worships false goods; an idolater; a heathen; one who is neither a Christian, a Mohammedan, nor a Jew. Neither having the accent of Christians, nor the gait of Christian, pagan, nor man. Shak.

PANIC: A sudden, overpowering fright; esp., a sudden and groundless fright; terror inspired by a trifling cause or a misapprehension of danger; as, the troops were seized with a panic; they fled in a panic.

PARROT: Any species of Psittacus, Chrysotis, Pionus, and other genera of the family Psittacidæ, as distinguished from the parrakeets, macaws, and lories. They have a short rounded or even tail, and often a naked space on the cheeks. The gray parrot, or jako (P. erithacus) of Africa (see Jako), and the species of Amazon, or green, parrots (Chrysotis) of America, are examples. Many species, as cage birds, readily learn to imitate sounds, and to repeat words and phrases. Carolina parrot (Zoöl.), the Carolina parrakeet. See Parrakeet.

PAUSE: To make a short stop; to cease for a time; to intermit speaking or acting; to stop; to wait; to rest. "Tarry, pause a day or two." Shak. Pausing while, thus to herself she mused. Milton.

PENUMBRA: An incomplete or partial shadow.

PERSON: The bodily form of a human being; body; outward appearance; as, of comely person. A fair persone, and strong, and young of age. Chaucer. If it assume my noble father's person. Shak. Love, sweetness, goodness, in her person shined. Milton.

PHRASE: A brief expression, sometimes a single word, but usually two or more words forming an expression by themselves, or being a portion of a sentence; as, an adverbial phrase. "Convey" the wise it call. "Steal!" foh! a fico for the phrase. Shak.

PING-PONG: An indoor modification of lawn tennis played with small bats, or battledores, and a very light, hollow, celluloid ball, on a large table divided across the middle by a net.

PLUMBER: One who works in lead; esp., one who furnishes, fits, and repairs lead, iron, or glass pipes, and other apparatus for the conveyance of water, gas, or drainage in buildings.

POLYHEDRON: A body or solid contained by many sides or planes.

POSTMAN: A post or courier; a letter carrier.

PREREQUISITE: Previously required; necessary as a preliminary to any proposed effect or end; as, prerequisite conditions of success.

PROBLEM: A question proposed for solution; a matter stated for examination or proof; hence, a matter difficult of solution or settlement; a doubtful case; a question involving doubt. Bacon.

PROXY: The agency for another who acts through the agent; authority to act for another, esp. to vote in a legislative or corporate capacity. I have no man's proxy: I speak only for myself. Burke.

PUZZLE: Something which perplexes or embarrasses; especially, a toy or a problem contrived for testing ingenuity; also, something exhibiting marvelous skill in making.

QUARTZ: A form of silica, or silicon dioxide (SiO2), occurring in hexagonal crystals, which are commonly colorless and transparent, but sometimes also yellow, brown, purple, green, and of other colors; also in cryptocrystalline massive forms varying in color and degree of transparency, being sometimes opaque.

RACCOON: A North American nocturnal carnivore (Procyon lotor) allied to the bears, but much smaller, and having a long, full tail, banded with black and gray. Its body is gray, varied with black and white. Called also coon, and mapach.

RATIONALIST: One who accepts rationalism as a theory or system; also, disparagingly, a false reasoner. See Citation under Reasonist.

RECONSIDER: To consider again; as, to reconsider a subject.

REFUND: To give back; to repay; to restore. A governor, that had pillaged the people, was . . . sentenced to refund what he had wrongfully taken. L'Estrange.

REMOVE: To move away from the position occupied; to cause to change place; to displace; as, to remove a building. Thou shalt not remove thy neighbor's landmark. Deut. xix. 14. When we had dined, to prevent the ladies' leaving us, I generally ordered the table to be removed. Goldsmith.

RESERVOIR: A place where anything is kept in store; especially, a place where water is collected and kept for use when wanted, as to supply a fountain, a canal, or a city by means of aqueducts, or to drive a mill wheel, or the like.

REVENGE: The act of revenging; vengeance; retaliation; a returning of evil for evil. Certainly, in taking revenge, a man is even with his enemy; but in passing it over he is superior. Bacon.

RIGOR: Exactness without allowance, deviation, or indulgence; strictness; as, the rigor of criticism; to execute a law with rigor; to enforce moral duties with rigor; -- opposed to Ant: lenity.

ROSE: A flower and shrub of any species of the genus Rosa, of which there are many species, mostly found in the morthern hemispere

RUN: To move, proceed, advance, pass, go, come, etc., swiftly, smoothly, or with quick action; -- said of things animate or inanimate. Hence, to flow, glide, or roll onward, as a stream, a snake, a wagon, etc.; to move by quicker action than in walking, as a person, a horse, a dog.

SAFFRON: The aromatic, pungent, dried stigmas, usually with part of the stile, of the Crocus sativus. Saffron is used in cookery, and in coloring confectionery, liquors, varnishes, etc., and was formerly much used in medicine.

SAP: The juice of plants of any kind, especially the ascending and descending juices or circulating fluid essential to nutrition.

SCAVENGER: A person whose employment is to clean the streets of a city, by scraping or sweeping, and carrying off the fifth. The name is also applied to any animal which devours refuse, carrion, or anything injurious to health. Scavenger beetle (Zoöl.), any beetle which feeds on decaying substances, as the carrion beetle.

SCRUB: To rub hard; to wash with rubbing; usually, to rub with a wet brush, or with something coarse or rough, for the purpose of cleaning or brightening; as, to scrub a floor, a doorplate.

SECTOR: A part of a circle comprehended between two radii and the included arc.

SENATOR: A member of a senate. The duke and senators of Venice greet you. Shak.

SEVEN: One more than six; six and one added; as, seven days make one week. Seven sciences. See the Note under Science, n., 4.

SHIN: The front part of the leg below the knee; the front edge of the shin bone; the lower part of the leg; the shank. "On his shin." Chaucer.

SIEVE: A utensil for separating the finer and coarser parts of a pulverized or granulated substance from each other. It consist of a vessel, usually shallow, with the bottom perforated, or made of hair, wire, or the like, woven in meshes. "In a sieve thrown and sifted." Chaucer.

SIX: The number greater by a unit than five; the sum of three and three; six units or objects.

SMASH: To break up, or to pieces suddenly, as the result of collision or pressure.

SOLID: Having the constituent parts so compact, or so firmly adhering, as to resist the impression or penetration of other bodies; having a fixed form; hard; firm; compact; -- opposed to fluid and liquid or to plastic, like clay, or to incompact, like sand.

SOVEREIGN: Supreme or highest in power; superior to all others; chief; as, our sovereign prince.

SPIN: To cause to turn round rapidly; to whirl; to twirl; as, to spin a top.

STALACTITE: A pendent cone or cylinder of calcium carbonate resembling an icicle in form and mode of attachment. Stalactites are found depending from the roof or sides of caverns, and are produced by deposition from waters which have percolated through, and partially dissolved, the overlying limestone rocks. (b) In an extended sense, any mineral or rock of similar form and origin; as, a stalactite of lava.

STEP: An advance or movement made by one removal of the foot; a pace.

STOP: To cease to go on; to halt, or stand still; to come to a stop. He bites his lip, and starts; Stops on a sudden, looks upon the ground; Then lays his finger on his temple: strait Springs out into fast gait; then stops again. Shak.

STRUGGLE: To strive, or to make efforts, with a twisting, or with contortions of the body.

SUBSCRIBE: To write underneath, as one's name; to sign (one's name) to a document. [They] subscribed their names under them. Sir T. More.

SUN: The luminous orb, the light of which constitutes day, and its absence night; the central body round which the earth and planets revolve, by which they are held in their orbits, and from which they receive light and heat. Its mean distance from the earth is about 92,500,000 miles, and its diameter about 860,000.

SUSPENSE: The state of being suspended; specifically, a state of uncertainty and expectation, with anxiety or apprehension; indetermination; indecision; as, the suspense of a person waiting for the verdict of a jury. Ten days the prophet in suspense remained. Denham. Upon the ticklish balance of suspense. Cowper.

SYMPHONY: A consonance or harmony of sounds, agreeable to the ear, whether the sounds are vocal or instrumental, or both. The trumpets sound, And warlike symphony in heard around. Dryden.

TAME: To reduce from a wild to a domestic state; to make gentle and familiar; to reclaim; to domesticate; as, to tame a wild beast. They had not been tamed into submission, but baited into savegeness and stubbornness. Macaulay.

TELEPHONE: An instrument for reproducing sounds, especially articulate speech, at a distance.

TEST: Examination or trial by the cupel; hence, any critical examination or decisive trial; as, to put a man's assertions to a test. "Bring me to the test." Shak.

THING: Whatever exists, or is conceived to exist, as a separate entity, whether animate or inanimate; any separable or distinguishable object of thought. God made . . . every thing that creepeth upon the earth after his kind. Gen. i. 25. He sent after this manner; ten asses laden with the good things of Egypt. Gen. xiv. 23. A thing of beauty is a joy forever. Keats.

TIGER: A very large and powerful carnivore (Felis tigris) native of Southern Asia and the East Indies. Its back and sides are tawny or rufous yellow, transversely striped with black, the tail is ringed with black, the throat and belly are nearly white. When full grown, it equals or exceeds the lion in size and strength. Called also royal tiger, and Bengal tiger.

TONGUE: an organ situated in the floor of the mouth of most vertebrates and connected with the hyoid arch.

TRADE: To barter, or to buy and sell; to be engaged in the exchange, purchase, or sale of goods, wares, merchandise, or anything else; to traffic; to bargain; to carry on commerce as a business. A free port, where nations . . . resorted with their goods and traded. Arbuthnot.

TREE: Any perennial woody plant of considerable size (usually over twenty feet high) and growing with a single trunk.

TROMBONE: A powerful brass instrument of the trumpet kind, thought by some to be the ancient sackbut, consisting of a tube in three parts, bent twice upon itself and ending in a bell. The middle part, bent double, slips into the outer parts, as in a telescope, so that by change of the vibrating length any tone within the compass of the instrument (which may be bass or tenor or alto or even, in rare instances, soprano) is commanded. It is the only member of the family of wind instruments whose scale, both diatonic and chromatic, is complete without the aid of keys or pistons, and which can slide from note to note as smoothly as the human voice or a violin. Softly blown, it has a rich and mellow sound, which becomes harsh and blatant when the tones are forced; used with discretion, its effect is often solemn and majestic.

TURKEY: Any large American gallinaceous bird belonging to the genus Meleagris, especially the North American wild turkey (Meleagris gallopavo), and the domestic turkey, which was probably derived from the Mexican wild turkey, but had been domesticated by the Indians long before the discovery of America.

TYPHUS: A contagious continued fever lasting from two to three weeks, attended with great prostration and cerebral disorder, and marked by a copious eruption of red spots upon the body. Also called jail fever, famine fever, putrid fever, spottled fever, etc. See Jail fever, under Jail.

UMBRELLA: A shade, screen, or guard, carried in the hand for sheltering the person from the rays of the sun, or from rain or snow. It is formed of silk, cotton, or other fabric, extended on strips of whalebone, steel, or other elastic material, inserted, or fastened to, a rod or stick by means of pivots or hinges, in such a way as to allow of being opened and closed with ease. See Parasol. Underneath the umbrella's oily shed. Gay.

UNDER: In a lower, subject, or subordinate condition; in subjection; - - used chiefly in a few idiomatic phrases; as, to bring under, to reduce to subjection; to subdue; to keep under, to keep in subjection; to control; to go under, to be unsuccessful; to fail. I keep under my body, and bring it into subjection. 1 Cor. ix. 27. The minstrel fell, but the foeman's chain Could not bring his proud soul under. Moore.

UNIVERSITY: An institution organized and incorporated for the purpose of imparting instruction, examining students, and otherwise promoting education in the higher branches of literature, science, art, etc., empowered to confer degrees in the several arts and faculties, as in theology, law, medicine, music, etc. A university may exist without having any college connected with it, or it may consist of but one college, or it may comprise an assemblage of colleges established in any place, with professors for instructing students in the sciences and other branches of learning. The present universities of Europe were, originally, the greater part of them, ecclesiastical corporations, instituted for the education of churchmen . . . What was taught in the greater part of those universities was suitable to the end of their institutions, either theology or something that was merely preparatory to theology. A. Smith.

UPRIGHT: In an erect position or posture; perpendicular; vertical, or nearly vertical; pointing upward; as, an upright tree. With chattering teeth, and bristling hair upright. Dryden. All have their ears upright. Spenser. 

VAMPIRE: A blood-sucking ghost; a soul of a dead person superstitiously believed to come from the grave and wander about by night sucking the blood of persons asleep, thus causing their death. This superstition is now prevalent in parts of Eastern Europe, and was especially current in Hungary about the year 1730. The persons who turn vampires are generally wizards, witches, suicides, and persons who have come to a violent end, or have been cursed by their parents or by the church, Encyc. Brit.

VERIFY: To prove to be true or correct; to establish the truth of; to confirm; to substantiate. This is verified by a number of examples. Bacon. So shalt thou best fulfill, best verify. The prophets old, who sung thy endless reign. Milton.

VIRTUAL: Being in essence or effect, not in fact; as, the virtual presence of a man in his agent or substitute. A thing has a virtual existence when it has all the conditions necessary to its actual existence. Fleming. To mask by slight differences in the manners a virtual identity in the substance. De Quincey. Principle of virtual velocities (Mech.), the law that when several forces are in equilibrium, the algebraic sum of their virtual moments is equal to zero.

WAGER: Something deposited, laid, or hazarded on the event of a contest or an unsettled question; a bet; a stake; a pledge. Besides these plates for horse races, the wagers may be as the persons please. Sir W. Temple. If any atheist can stake his soul for a wager against such an inexhaustible disproportion, let him never hereafter accuse others of credulity. Bentley.

WATCHMAN: One set to watch; a person who keeps guard; a guard; a sentinel.

WELCOME: Received with gladness; admitted willingly to the house, entertainment, or company; as, a welcome visitor. When the glad soul is made Heaven's welcome guest. Cowper.

WHITTLE: To pare or cut off the surface of with a small knife; to cut or shape, as a piece of wood held in the hand, with a clasp knife or pocketknife.

WITHOUT: On or art the outside; not on the inside; not within; outwardly; externally. Without were fightings, within were fears. 2 Cor. vii. 5.

WRIST: The joint, or the region of the joint, between the hand and the arm; the carpus. See Carpus. He took me by the wrist, and held me hard. Shak.

YAM: A large, esculent, farinaceous tuber of various climbing plants of the genus Dioscorea; also, the plants themselves. Mostly natives of warm climates. The plants have netted-veined, petioled leaves, and pods with three broad wings. The commonest species is D. sativa, but several others are cultivated. Chinese yam, a plant (Dioscorea Batatas) with a long and slender tuber, hardier than most of the other species.

YTTERBIUM: A rare element of the boron group, sometimes associated with yttrium or other related elements, as in euxenite and gadolinite. Symbol Yb; provisional atomic weight 173.2. Cf. Yttrium.

ZOOLOGY: That part of biology which relates to the animal kingdom, including the structure, embryology, evolution, classification, habits, and distribution of all animals, both living and extinct.

ZOROASTRIAN: A follower of Zoroaster; one who accepts Zoroastrianism.
